report_date,report_source,report_period,ext_massacres_cum,killed,killed_cum,ext_killed,ext_killed_cum,ext_killed_children_cum,ext_killed_women_cum,injured_cum,ext_injured,ext_injured_cum,ext_civdef_killed_cum,med_killed_cum,ext_med_killed_cum,press_killed_cum,ext_press_killed_cum,killed_recovered,killed_succumbed,killed_truce_new,killed_committee
1696636800000000000,mohtel,24,0,232,232,232,232,0,0,1610,1610,1610,0,6,6,1,1,0,0,0,0
1696723200000000000,mohtel,24,0,138,370,138,370,78,41,1788,178,1788,0,6,6,1,1,0,0,0,0
1696809600000000000,mohtel,24,8,190,560,190,560,91,61,2271,483,2271,0,6,6,3,3,0,0,0,0
1696896000000000000,mohtel,24,8,340,900,340,900,260,230,4000,1729,4000,0,6,6,7,7,0,0,0,0
1696982400000000000,mohtel,24,23,200,1100,200,1100,398,230,5184,1184,5184,0,10,10,7,7,0,0,0,0
1697068800000000000,mohtel,24,23,317,1417,317,1417,500,276,5763,579,5763,0,11,11,7,7,0,0,0,0
1697155200000000000,unknown,24,23,483,1900,483,1900,500,392,5763,1475,7238,0,11,11,7,7,0,0,0,0
1697241600000000000,mohtel,24,23,328,2228,328,2228,600,600,8714,1476,8714,0,11,11,7,7,0,0,0,0
1697328000000000000,mohtel,24,23,442,2670,442,2670,700,735,9200,486,9200,0,11,11,7,7,0,0,0,0
1697414400000000000,mohtel,24,371,138,2808,138,2808,853,936,10850,1650,10850,7,37,37,7,7,0,0,0,0
1697500800000000000,mohtel,24,394,192,3000,192,3000,940,936,10850,607,11457,7,37,37,16,16,0,0,0,0
1697587200000000000,mohtel,24,394,478,3478,478,3478,1000,936,12065,608,12065,7,37,37,16,16,0,0,0,0
1697673600000000000,mohtel,24,394,307,3785,307,3785,1524,936,12493,428,12493,7,44,44,16,16,0,0,0,0
1697760000000000000,mohtel,24,431,352,4137,352,4137,1756,936,13162,669,13162,7,46,46,16,16,0,0,0,0
1697846400000000000,mohtel,24,460,248,4385,248,4385,1756,967,13561,399,13561,7,51,51,16,16,0,0,0,0
1697932800000000000,mohtel,24,484,266,4651,266,4651,1873,1023,14245,684,14245,7,54,54,16,16,0,0,0,0
1698019200000000000,mohtel,24,507,436,5087,436,5087,2055,1119,15273,1028,15273,7,57,57,16,16,0,0,0,0
1698105600000000000,mohtel,24,644,704,5791,704,5791,2360,1292,16297,1024,16297,7,65,65,16,16,0,0,0,0
1698192000000000000,mohtel,24,688,756,6547,756,6547,2704,1584,17439,1142,17439,7,73,73,16,16,0,0,0,0
1698278400000000000,mohtel,24,731,481,7028,481,7028,3038,1600,18482,1043,18482,7,101,101,16,16,0,0,0,0
1698364800000000000,mohtel,24,772,298,7326,298,7326,3038,1726,18967,485,18967,7,104,104,16,16,0,0,0,0
1698451200000000000,unknown,24,772,377,7703,377,7703,3168,1916,18967,637,19604,7,104,104,16,16,0,0,0,0
1698537600000000000,mohtel,24,881,302,8005,302,8005,3324,2062,20242,638,20242,7,116,116,16,16,0,0,0,0
1698624000000000000,mohtel,24,908,304,8309,304,8309,3457,2136,21048,806,21048,18,124,124,35,35,0,0,0,0
1698710400000000000,mohtel,24,926,216,8525,216,8525,3542,2187,21543,495,21543,18,130,130,35,35,0,0,0,0
1698796800000000000,mohtel,24,950,280,8805,280,8805,3650,2252,22240,697,22240,18,132,132,35,35,0,0,0,0
1698883200000000000,mohtel,24,965,256,9061,256,9061,3760,2326,22911,671,22911,18,134,134,35,35,0,0,0,0
1698969600000000000,mohtel,24,997,196,9257,196,9257,3826,2405,23516,605,23516,18,136,136,35,35,0,0,0,0
1699056000000000000,mohtel,24,1006,228,9485,228,9485,3900,2509,24158,642,24158,18,150,150,35,35,0,0,0,0
1699142400000000000,mohtel,24,1031,285,9770,285,9770,4008,2550,24808,650,24808,18,175,175,35,35,0,0,0,0
1699228800000000000,mohtel,24,1031,252,10022,252,10022,4108,2610,25000,192,25000,18,192,192,35,35,0,0,0,0
1699315200000000000,mohtel,24,1071,306,10328,306,10328,4237,2719,25956,956,25956,18,192,192,35,35,0,0,0,0
1699401600000000000,mohtel,24,1098,241,10569,241,10569,4324,2823,26475,519,26475,18,193,193,35,35,0,0,0,0
1699488000000000000,mohtel,24,1118,249,10818,249,10818,4412,2918,26905,430,26905,18,195,195,35,35,0,0,0,0
1699574400000000000,mohtel,24,1130,260,11078,260,11078,4506,3027,27490,585,27490,20,198,198,49,49,0,0,0,0
1699660800000000000,unknown,24,1130,0,11078,51,11129,4540,3044,27490,355,27845,20,198,198,49,49,0,0,0,0
1699747200000000000,mohtel,24,1142,0,11078,51,11180,4609,3100,28200,355,28200,20,198,198,49,49,0,0,0,0
1699833600000000000,mohtel,24,1153,0,11078,60,11240,4630,3130,29000,800,29000,21,198,198,51,51,0,0,0,0
1699920000000000000,mohtel,24,1165,0,11078,80,11320,4650,3145,29200,200,29200,22,198,198,51,51,0,0,0,0
1700006400000000000,mohtel,24,1200,0,11078,180,11500,4710,3160,29800,600,29800,22,200,200,51,51,0,0,0,0
1700092800000000000,unknown,24,1200,0,11078,500,12000,5000,3300,29800,100,29900,22,200,200,51,51,0,0,0,0
1700179200000000000,mohtel,24,1270,0,11078,0,12000,5000,3300,30000,100,30000,22,200,200,51,51,0,0,0,0
1700265600000000000,mohtel,24,1300,0,11078,300,12300,5000,3300,30000,0,30000,22,200,200,56,56,0,0,0,0
1700352000000000000,mohtel,24,1330,0,11078,700,13000,5500,3500,30000,0,30000,22,201,201,60,60,0,0,0,0
1700438400000000000,mohtel,24,1340,0,11078,300,13300,5600,3550,31000,1000,31000,22,201,201,60,60,0,0,0,0
1700524800000000000,mohtel,24,1354,0,11078,828,14128,5840,3920,33000,2000,33000,22,205,205,60,60,0,0,0,0
1700611200000000000,mohtel,24,1384,0,11078,404,14532,6000,4000,35000,2000,35000,25,205,205,64,64,0,0,0,0
1700697600000000000,mohtel,24,1400,0,11078,268,14800,6150,4000,36000,1000,36000,26,207,207,65,65,0,0,0,0
1700784000000000000,unknown,24,1400,0,11078,0,14800,6150,4000,36000,0,36000,26,207,207,65,65,0,0,0,0
1700870400000000000,unknown,24,1400,0,11078,0,14800,6150,4000,36000,0,36000,26,207,207,67,67,0,0,0,0
1700956800000000000,unknown,24,1400,0,11078,0,14800,6150,4000,36000,0,36000,26,207,207,67,67,0,0,0,0
1701043200000000000,mohtel,24,1400,0,11078,0,14800,6150,4000,36000,0,36000,26,207,207,70,70,0,0,0,0
1701129600000000000,mohtel,24,1400,0,11078,0,14800,6150,4000,36000,0,36000,26,207,207,70,70,0,0,0,0
1701216000000000000,unknown,24,1400,0,11078,0,14800,6150,4000,36000,0,36000,26,207,207,70,70,0,0,0,0
1701302400000000000,unknown,24,1400,0,11078,0,14800,6150,4000,36000,0,36000,26,207,207,70,70,0,0,0,0
1701388800000000000,mohtel,24,1400,0,11078,0,14800,6150,4000,37000,1000,37000,26,280,280,73,73,0,0,0,0
1701475200000000000,mohtel,24,1450,407,11485,407,15207,6387,4257,40652,3652,40652,26,280,280,76,76,0,0,0,0
1701561600000000000,mohtel,24,1473,316,11801,316,15523,6600,4300,41316,664,41316,26,281,281,77,77,0,0,0,0
1701648000000000000,mohtel,24,1473,376,12177,376,15899,6800,4500,42000,684,42000,26,283,283,77,77,0,0,0,0
1701734400000000000,mohtel,24,1550,725,12902,349,16248,7112,4885,43616,1616,43616,32,286,286,81,81,0,0,0,0
1701820800000000000,unknown,24,1550,0,12902,579,16827,7550,5000,43616,1192,44808,32,286,286,81,81,0,0,0,0
1701907200000000000,mohtel,24,1576,350,13252,350,17177,7729,5153,46000,1192,46000,32,290,290,81,81,0,0,0,0
1701993600000000000,mohtel,24,1576,313,13565,310,17487,7729,5246,46480,480,46480,32,290,295,81,81,0,0,0,0
1702080000000000000,mohtel,24,1596,210,13775,213,17700,7870,6121,48780,2300,48780,32,295,295,81,81,0,0,0,0
1702166400000000000,mohtel,24,1617,297,14072,297,17997,7875,6130,49229,449,49229,32,296,296,81,81,0,0,0,0
1702252800000000000,mohtel,24,1636,208,14280,208,18205,7900,6150,49645,416,49645,32,296,296,81,81,0,0,0,0
1702339200000000000,mohtel,24,1644,207,14487,207,18412,8000,6200,50100,455,50100,32,300,300,86,86,0,0,0,0
1702425600000000000,mohtel,24,1660,196,14683,196,18608,8000,6200,50594,494,50594,32,300,300,86,86,0,0,0,0
1702512000000000000,mohtel,24,1678,179,14862,179,18787,8000,6200,50897,303,50897,32,300,300,86,86,0,0,0,0
1702598400000000000,mohtel,24,1680,0,14862,13,18800,8000,6200,51000,103,51000,32,300,300,89,89,0,0,0,0
1702684800000000000,unknown,24,1680,0,14862,217,19017,8000,6200,51000,200,51200,32,300,300,89,89,0,0,0,0
1702771200000000000,unknown,24,1680,0,14862,218,19235,8000,6200,51000,543,51743,32,300,300,89,89,0,0,0,0
1702857600000000000,mohtel,24,1696,151,15013,218,19453,8000,6200,52286,543,52286,32,300,300,96,96,0,0,0,0
1702944000000000000,mohtel,24,1697,214,15227,214,19667,8000,6200,52586,300,52586,35,310,310,97,97,0,0,0,0
1703030400000000000,mohtel,24,1697,0,15227,130,19797,8000,6200,52586,245,52831,35,310,310,97,97,0,0,0,0
1703116800000000000,mohtel,24,1697,0,15227,130,19927,8000,6200,52586,244,53075,35,310,310,97,97,0,0,0,0
1703203200000000000,mohtel,24,1697,390,15617,130,20057,8000,6200,53320,245,53320,35,310,310,97,97,0,0,0,0
1703289600000000000,mohtel,24,1697,201,15818,201,20258,8200,6200,53688,368,53688,35,310,310,100,100,0,0,0,0
1703376000000000000,mohtel,24,1697,166,15984,166,20424,8200,6200,54036,348,54036,35,310,310,100,100,0,0,0,0
1703462400000000000,mohtel,24,1745,250,16234,250,20674,8500,6300,54536,500,54536,40,311,311,103,103,0,0,0,0
1703548800000000000,mohtel,24,1763,241,16475,241,20915,8500,6300,54918,382,54918,40,311,311,103,103,0,0,0,0
1703635200000000000,mohtel,24,1779,195,16670,195,21110,8800,6300,55243,325,55243,40,311,311,103,103,0,0,0,0
1703721600000000000,mohtel,24,1799,210,16880,210,21320,8800,6300,55603,360,55603,40,311,311,103,103,0,0,0,0
1703808000000000000,mohtel,24,1799,187,17067,187,21507,8800,6300,55915,312,55915,40,311,311,103,103,0,0,0,0
1703894400000000000,mohtel,24,1813,165,17232,165,21672,9000,6450,56165,250,56165,40,312,312,106,106,0,0,0,0
1703980800000000000,mohtel,24,1825,150,17382,150,21822,9100,6500,56451,286,56451,40,312,312,106,106,0,0,0,0
1704067200000000000,mohtel,24,1838,156,17538,156,21978,9280,6600,56697,246,56697,40,326,326,106,106,0,0,0,0
1704153600000000000,mohtel,24,1853,207,17745,207,22185,9280,6600,57035,338,57035,40,326,326,106,106,0,0,0,0
1704240000000000000,mohtel,24,1863,128,17873,128,22313,9400,6700,57296,261,57296,40,326,326,106,106,0,0,0,0
1704326400000000000,mohtel,24,1876,125,17998,125,22438,9730,6830,57614,318,57614,40,326,326,106,106,0,0,0,0
1704412800000000000,mohtel,24,1891,162,18160,162,22600,9730,6830,57910,296,57910,40,326,326,106,106,0,0,0,0
1704499200000000000,mohtel,24,1903,122,18282,122,22722,10000,7000,58166,256,58166,40,326,326,106,106,0,0,0,0
1704585600000000000,mohtel,24,1915,113,18395,113,22835,10000,7000,58416,250,58416,40,326,326,106,106,0,0,0,0
1704672000000000000,mohtel,24,1932,249,18644,249,23084,10000,7000,58926,510,58926,40,326,326,106,106,0,0,0,0
1704758400000000000,mohtel,24,1944,126,18770,126,23210,10000,7000,59167,241,59167,40,326,326,106,106,0,0,0,0
1704844800000000000,mohtel,24,1958,147,18917,147,23357,10000,7000,59410,243,59410,40,326,326,106,106,0,0,0,0
1704931200000000000,mohtel,24,1968,112,19029,112,23469,10300,7100,59604,194,59604,40,337,337,106,106,0,0,0,0
1705017600000000000,mohtel,24,1981,151,19180,239,23708,10300,7100,60005,401,60005,40,337,337,106,106,0,0,0,0
1705104000000000000,mohtel,24,1993,135,19315,135,23843,10400,7100,60317,312,60317,45,337,337,117,117,0,0,0,0
1705190400000000000,mohtel,24,2004,125,19440,125,23968,10600,7200,60582,265,60582,45,337,337,117,117,0,0,0,0
1705276800000000000,mohtel,24,2016,132,19572,132,24100,10600,7200,60834,252,60834,45,337,337,118,118,0,0,0,0
1705363200000000000,mohtel,24,2031,158,19730,185,24285,10600,7200,61154,320,61154,45,337,337,118,118,0,0,0,0
1705449600000000000,mohtel,24,2031,163,19893,163,24448,10600,7200,61504,350,61504,45,337,337,118,118,0,0,0,0
1705536000000000000,mohtel,24,2046,172,20065,172,24620,10800,7250,61830,326,61830,45,337,337,119,119,0,0,0,0
1705622400000000000,mohtel,24,2058,142,20207,142,24762,10800,7250,62108,278,62108,45,337,337,119,119,0,0,0,0
1705708800000000000,mohtel,24,2072,165,20372,165,24927,10800,7250,62388,280,62388,45,337,337,119,119,0,0,0,0
1705795200000000000,mohtel,24,2087,178,20550,178,25105,10800,7250,62681,293,62681,45,337,337,119,119,0,0,0,0
1705881600000000000,mohtel,24,2119,190,20740,190,25295,11000,7500,63000,319,63000,45,337,337,119,119,0,0,0,0
1705968000000000000,mohtel,24,2141,195,20935,195,25490,11000,7500,63354,354,63354,45,337,337,119,119,0,0,0,0
1706054400000000000,mohtel,24,2165,210,21145,210,25700,11000,7500,63740,386,63740,45,337,337,119,119,0,0,0,0
1706140800000000000,mohtel,24,2186,200,21345,200,25900,11000,7500,64110,370,64110,45,337,337,119,119,0,0,0,0
1706227200000000000,mohtel,24,2205,183,21528,183,26083,11000,7500,64487,377,64487,45,337,337,119,119,0,0,0,0
1706313600000000000,mohtel,24,2223,174,21702,174,26257,11000,7500,64797,310,64797,45,337,337,120,120,0,0,0,0
1706400000000000000,mohtel,24,2242,165,21867,165,26422,11000,7500,65087,290,65087,45,337,337,120,120,0,0,0,0
1706486400000000000,mohtel,24,2256,215,22082,215,26637,11000,7500,65387,300,65387,45,337,337,122,122,0,0,0,0
1706572800000000000,mohtel,24,2269,114,22196,114,26751,11500,8000,65636,249,65636,46,339,339,122,122,0,0,0,0
1706659200000000000,mohtel,24,2285,149,22345,149,26900,11500,8000,65949,313,65949,46,339,339,122,122,0,0,0,0
1706745600000000000,mohtel,24,2300,119,22464,119,27019,11500,8000,66139,190,66139,46,339,339,122,122,0,0,0,0
1706832000000000000,mohtel,24,2313,112,22576,112,27131,11500,8000,66287,148,66287,46,339,339,122,122,0,0,0,0
1706918400000000000,mohtel,24,2325,107,22683,107,27238,12000,8190,66452,165,66452,46,339,339,122,122,0,0,0,0
1707004800000000000,mohtel,24,2339,127,22810,127,27365,12000,8190,66630,178,66630,46,339,339,122,122,0,0,0,0
1707091200000000000,mohtel,24,2352,113,22923,113,27478,12000,8190,66835,205,66835,46,339,339,122,122,0,0,0,0
1707177600000000000,mohtel,24,2364,107,23030,107,27585,12000,8190,66978,143,66978,46,339,339,122,122,0,0,0,0
1707264000000000000,mohtel,24,2380,123,23153,123,27708,12000,8190,67147,169,67147,46,339,339,123,123,0,0,0,0
1707350400000000000,mohtel,24,2395,132,23285,132,27840,12150,8300,67317,170,67317,46,340,340,124,124,0,0,0,0
1707436800000000000,mohtel,24,2408,107,23392,107,27947,12150,8300,67459,142,67459,46,340,340,124,124,0,0,0,0
1707523200000000000,mohtel,24,2424,117,23509,117,28064,12150,8300,67611,152,67611,46,340,340,124,124,0,0,0,0
1707609600000000000,mohtel,24,2438,112,23621,112,28176,12300,8400,67784,173,67784,46,340,340,124,124,0,0,0,0
1707696000000000000,mohtel,24,2457,164,23785,164,28340,12300,8400,67984,200,67984,46,340,340,126,126,0,0,0,0
1707782400000000000,mohtel,24,2473,133,23918,133,28473,12300,8400,68146,162,68146,46,340,340,126,126,0,0,0,0
1707868800000000000,mohtel,24,2484,103,24021,103,28576,12300,8400,68291,145,68291,46,340,340,126,126,0,0,0,0
1707955200000000000,mohtel,24,2493,87,24108,87,28663,12300,8400,68395,104,68395,46,340,340,126,126,0,0,0,0
1708041600000000000,mohtel,24,2503,112,24220,112,28775,12660,8570,68552,157,68552,46,340,340,130,130,0,0,0,0
1708128000000000000,mohtel,24,2512,83,24303,83,28858,12660,8570,68677,125,68677,46,340,340,130,130,0,0,0,0
1708214400000000000,mohtel,24,2525,127,24430,127,28985,12660,8570,68883,206,68883,46,340,340,130,130,0,0,0,0
1708300800000000000,mohtel,24,2534,107,24537,107,29092,12660,8570,69028,145,69028,46,340,340,130,130,0,0,0,0
1708387200000000000,mohtel,24,2543,103,24640,103,29195,12660,8570,69170,142,69170,46,340,340,130,130,0,0,0,0
1708473600000000000,mohtel,24,2554,118,24758,118,29313,12660,8570,69333,163,69333,46,340,340,130,130,0,0,0,0
1708560000000000000,mohtel,24,2563,97,24855,97,29410,12660,8570,69465,132,69465,46,340,340,130,130,0,0,0,0
1708646400000000000,mohtel,24,2573,104,24959,104,29514,13000,8800,69616,151,69616,47,340,340,132,132,0,0,0,0
1708732800000000000,mohtel,24,2581,92,25051,92,29606,13000,8800,69737,121,69737,47,340,340,132,132,0,0,0,0
1708819200000000000,mohtel,24,2589,86,25137,86,29692,13000,8800,69879,142,69879,47,340,340,132,132,0,0,0,0
1708905600000000000,mohtel,24,2599,90,25227,90,29782,13000,8800,70043,164,70043,47,340,340,132,132,0,0,0,0
1708992000000000000,mohtel,24,2610,96,25323,96,29878,13000,8800,70215,172,70215,47,340,340,132,132,0,0,0,0
1709078400000000000,mohtel,24,2618,76,25399,76,29954,13000,8800,70325,110,70325,47,340,340,132,132,0,0,0,0
1709164800000000000,mohtel,24,2627,81,25480,81,30035,13230,8860,70457,132,70457,47,340,340,132,132,0,0,0,0
1709251200000000000,mohtel,24,2643,193,25673,193,30228,13230,8860,71377,920,71377,47,340,340,132,132,0,0,0,0
1709337600000000000,mohtel,24,2653,92,25765,92,30320,13230,8860,71533,156,71533,47,340,340,132,132,0,0,0,0
1709424000000000000,mohtel,24,2662,90,25855,90,30410,13230,8860,71710,177,71710,47,342,342,132,132,0,0,0,0
1709510400000000000,mohtel,24,2675,124,25979,124,30534,13430,8900,71920,210,71920,48,364,364,132,132,0,0,0,0
1709596800000000000,mohtel,24,2685,97,26076,97,30631,13430,8900,72043,123,72043,48,364,364,132,132,0,0,0,0
1709683200000000000,mohtel,24,2694,86,26162,86,30717,13430,8900,72156,113,72156,48,364,364,133,133,0,0,0,0
1709769600000000000,mohtel,24,2703,83,26245,83,30800,13430,8900,72298,142,72298,48,364,364,133,133,0,0,0,0
1709856000000000000,mohtel,24,2711,78,26323,78,30878,13430,8900,72402,104,72402,48,364,364,133,133,0,0,0,0
1709942400000000000,mohtel,24,2713,82,26405,82,30960,13500,9000,72524,122,72524,48,364,364,133,133,0,0,0,0
1710028800000000000,mohtel,24,2721,85,26490,85,31045,13500,9000,72654,130,72654,48,364,364,133,133,0,0,0,0
1710115200000000000,mohtel,24,2728,67,26557,67,31112,13500,9000,72760,106,72760,48,364,364,133,133,0,0,0,0
1710201600000000000,mohtel,24,2736,72,26629,72,31184,13500,9000,72889,129,72889,48,364,364,133,133,0,0,0,0
1710288000000000000,mohtel,24,2746,88,26717,88,31272,13500,9000,73024,135,73024,48,364,364,133,133,0,0,0,0
1710374400000000000,mohtel,24,2761,69,26786,69,31341,13790,9100,73134,110,73134,48,364,364,133,133,0,0,0,0
1710460800000000000,mohtel,24,2774,149,26935,149,31490,13790,9100,73434,300,73434,48,364,364,133,133,0,0,0,0
1710547200000000000,mohtel,24,2781,63,26998,63,31553,13790,9100,73546,112,73546,48,364,364,133,133,0,0,0,0
1710633600000000000,mohtel,24,2790,92,27090,92,31645,13790,9100,73676,130,73676,48,364,364,133,133,0,0,0,0
1710720000000000000,mohtel,24,2798,81,27171,81,31726,13790,9100,73792,116,73792,48,364,364,133,133,0,0,0,0
1710806400000000000,mohtel,24,2807,93,27264,93,31819,14000,9220,73934,142,73934,48,364,364,135,135,0,0,0,0
1710892800000000000,mohtel,24,2817,104,27368,104,31923,14000,9220,74096,162,74096,48,364,364,135,135,0,0,0,0
1710979200000000000,mohtel,24,2824,65,27433,65,31988,14000,9220,74188,92,74188,48,364,364,135,135,0,0,0,0
1711065600000000000,mohtel,24,2833,82,27515,82,32070,14000,9220,74298,110,74298,48,364,364,135,135,0,0,0,0
1711152000000000000,mohtel,24,2840,72,27587,72,32142,14000,9220,74412,114,74412,48,364,364,135,135,0,0,0,0
1711238400000000000,mohtel,24,2848,84,27671,84,32226,14280,9340,74518,106,74518,48,364,364,136,136,0,0,0,0
1711324800000000000,mohtel,24,2859,107,27778,107,32333,14280,9340,74694,176,74694,48,364,364,136,136,0,0,0,0
1711411200000000000,mohtel,24,2867,81,27859,81,32414,14280,9340,74787,93,74787,48,364,364,136,136,0,0,0,0
1711497600000000000,mohtel,24,2875,76,27935,76,32490,14280,9340,74889,102,74889,48,364,364,136,136,0,0,0,0
1711584000000000000,mohtel,24,2881,62,27997,62,32552,14280,9340,74980,91,74980,48,364,364,136,136,0,0,0,0
1711670400000000000,mohtel,24,2888,71,28068,71,32623,14350,9460,75092,112,75092,48,364,364,136,136,0,0,0,0
1711756800000000000,mohtel,24,2896,82,28150,82,32705,14350,9460,75190,98,75190,48,364,364,136,136,0,0,0,0
1711843200000000000,mohtel,24,2904,77,28227,77,32782,14350,9460,75298,108,75298,48,364,364,137,137,0,0,0,0
1711929600000000000,mohtel,24,2910,63,28290,63,32845,14350,9460,75392,94,75392,48,364,364,138,138,0,0,0,0
1712016000000000000,mohtel,24,2917,71,28361,71,32916,14350,9460,75494,102,75494,48,364,364,138,138,0,0,0,0
1712102400000000000,mohtel,24,2922,59,28420,59,32975,14500,9560,75577,83,75577,65,484,484,140,140,0,0,0,0
1712188800000000000,mohtel,24,2928,62,28482,62,33037,14500,9560,75668,91,75668,65,484,484,140,140,0,0,0,0
1712275200000000000,mohtel,24,2933,54,28536,54,33091,14500,9560,75750,82,75750,65,484,484,140,140,0,0,0,0
1712361600000000000,mohtel,24,2937,46,28582,46,33137,14500,9560,75815,65,75815,65,484,484,140,140,0,0,0,0
1712448000000000000,mohtel,24,2941,38,28620,38,33175,14500,9560,75886,71,75886,65,484,484,140,140,0,0,0,0
1712534400000000000,mohtel,24,2941,32,28652,32,33207,14520,9568,75933,47,75933,65,485,485,140,140,0,0,0,0
1712620800000000000,mohtel,24,2948,153,28805,153,33360,14520,9568,75993,60,75993,65,485,485,140,140,0,0,0,0
1712707200000000000,mohtel,24,2954,122,28927,122,33482,14520,9568,76049,56,76049,65,485,485,140,140,0,0,0,0
1712793600000000000,mohtel,24,2960,63,28990,63,33545,14520,9568,76094,45,76094,65,485,485,140,140,0,0,0,0
1712880000000000000,mohtel,24,2968,89,29079,89,33634,14520,9568,76214,120,76214,65,485,485,140,140,0,0,0,0
1712966400000000000,mohtel,24,2973,52,29131,52,33686,14560,9582,76309,95,76309,66,485,485,140,140,0,0,0,0
1713052800000000000,mohtel,24,2977,43,29174,43,33729,14560,9582,76371,62,76371,66,485,485,140,140,0,0,0,0
1713139200000000000,mohtel,24,2984,68,29242,68,33797,14560,9582,76465,94,76465,66,485,485,140,140,0,0,0,0
1713225600000000000,mohtel,24,2989,46,29288,46,33843,14560,9582,76575,110,76575,66,485,485,140,140,0,0,0,0
1713312000000000000,mohtel,24,2995,56,29344,56,33899,14560,9582,76664,89,76664,66,485,485,140,140,0,0,0,0
1713398400000000000,mohtel,24,3002,71,29415,71,33970,14685,9670,76770,106,76770,66,485,485,140,140,0,0,0,0
1713484800000000000,mohtel,24,3006,42,29457,42,34012,14685,9670,76833,63,76833,66,485,485,140,140,0,0,0,0
1713571200000000000,mohtel,24,3010,37,29494,37,34049,14685,9670,76901,68,76901,66,485,485,140,140,0,0,0,0
1713657600000000000,mohtel,24,3015,48,29542,48,34097,14685,9670,76980,79,76980,66,485,485,140,140,0,0,0,0
1713744000000000000,mohtel,24,3021,54,29596,54,34151,14685,9670,77084,104,77084,66,485,485,140,140,0,0,0,0
1713830400000000000,mohtel,24,3025,32,29628,32,34183,14778,9752,77143,59,77143,67,485,485,140,140,0,0,0,0
1713916800000000000,mohtel,24,3031,79,29707,79,34262,14778,9752,77229,86,77229,67,485,485,140,140,0,0,0,0
1714003200000000000,mohtel,24,3036,43,29750,43,34305,14778,9752,77293,64,77293,67,485,485,141,141,0,0,0,0
1714089600000000000,mohtel,24,3041,51,29801,51,34356,14778,9752,77368,75,77368,67,485,485,141,141,0,0,0,0
1714176000000000000,mohtel,24,3045,32,29833,32,34388,14778,9752,77437,69,77437,67,485,485,141,141,0,0,0,0
1714262400000000000,mohtel,24,3052,66,29899,66,34454,14873,9801,77575,138,77575,67,491,491,141,141,0,0,0,0
1714348800000000000,mohtel,24,3055,34,29933,34,34488,14873,9801,77643,68,77643,67,491,491,141,141,0,0,0,0
1714435200000000000,mohtel,24,3060,47,29980,47,34535,14873,9801,77704,61,77704,67,491,491,141,141,0,0,0,0
1714521600000000000,mohtel,24,3064,33,30013,33,34568,14873,9801,77765,61,77765,67,491,491,141,141,0,0,0,0
1714608000000000000,mohtel,24,3067,28,30041,28,34596,14873,9801,77816,51,77816,67,491,491,141,141,0,0,0,0
1714694400000000000,mohtel,24,3070,26,30067,26,34622,14944,9849,77867,51,77867,68,492,492,141,141,0,0,0,0
1714780800000000000,mohtel,24,3073,32,30099,32,34654,14944,9849,77908,41,77908,68,492,492,141,141,0,0,0,0
1714867200000000000,mohtel,24,3076,29,30128,29,34683,14944,9849,78018,110,78018,68,492,492,141,141,0,0,0,0
1714953600000000000,mohtel,24,3081,52,30180,52,34735,14944,9849,78108,90,78108,68,492,492,142,142,0,0,0,0
1715040000000000000,mohtel,24,3087,54,30234,54,34789,14944,9849,78204,96,78204,68,492,492,142,142,0,0,0,0
1715126400000000000,mohtel,24,3094,55,30289,55,34844,15002,9893,78404,200,78404,68,492,492,142,142,0,0,0,0
1715212800000000000,mohtel,24,3098,60,30349,60,34904,15002,9893,78514,110,78514,68,492,492,142,142,0,0,0,0
1715299200000000000,mohtel,24,3104,39,30388,39,34943,15002,9893,78572,58,78572,68,492,492,142,142,0,0,0,0
1715385600000000000,mohtel,24,3108,28,30416,28,34971,15002,9893,78641,69,78641,68,492,492,143,143,0,0,0,0
1715472000000000000,mohtel,24,3116,63,30479,63,35034,15002,9893,78755,114,78755,68,492,492,143,143,0,0,0,0
1715558400000000000,mohtel,24,3123,57,30536,57,35091,15103,9961,78827,72,78827,69,492,492,143,143,0,0,0,0
1715644800000000000,mohtel,24,3131,82,30618,82,35173,15103,9961,79061,234,79061,69,492,492,143,143,0,0,0,0
1715731200000000000,mohtel,24,3136,60,30678,60,35233,15103,9961,79141,80,79141,69,492,492,143,143,0,0,0,0
1715817600000000000,mohtel,24,3140,39,30717,39,35272,15103,9961,79205,64,79205,69,492,492,147,147,0,0,0,0
1715904000000000000,mohtel,24,3144,31,30748,31,35303,15103,9961,79261,56,79261,69,492,492,147,147,0,0,0,0
1715990400000000000,mohtel,24,3153,83,30831,83,35386,15162,10018,79366,105,79366,69,492,492,147,147,0,0,0,0
1716076800000000000,mohtel,24,3161,70,30901,70,35456,15162,10018,79476,110,79476,69,492,492,147,147,0,0,0,0
1716163200000000000,mohtel,24,3171,106,31007,106,35562,15162,10018,79652,176,79652,69,492,492,147,147,0,0,0,0
1716249600000000000,mohtel,24,3176,85,31092,85,35647,15162,10018,79852,200,79852,69,492,492,147,147,0,0,0,0
1716336000000000000,mohtel,24,3182,62,31154,62,35709,15162,10018,79990,138,79990,69,492,492,147,147,0,0,0,0
1716422400000000000,mohtel,24,3191,91,31245,91,35800,15239,10093,80200,210,80200,69,493,493,147,147,0,0,0,0
1716508800000000000,mohtel,24,3197,57,31302,57,35857,15239,10093,80293,93,80293,69,493,493,147,147,0,0,0,0
1716595200000000000,mohtel,24,3202,46,31348,46,35903,15239,10093,80420,127,80420,69,493,493,147,147,0,0,0,0
1716681600000000000,mohtel,24,3210,81,31429,81,35984,15239,10093,80643,223,80643,69,493,493,147,147,0,0,0,0
1716768000000000000,mohtel,24,3217,66,31495,66,36050,15239,10093,81026,383,81026,69,495,495,147,147,0,0,0,0
1716854400000000000,mohtel,24,3222,46,31541,46,36096,15328,10171,81136,110,81136,69,496,496,147,147,0,0,0,0
1716940800000000000,mohtel,24,3228,75,31616,75,36171,15328,10171,81420,284,81420,69,496,496,147,147,0,0,0,0
1717027200000000000,mohtel,24,3233,53,31669,53,36224,15328,10171,81777,357,81777,69,498,498,147,147,0,0,0,0
1717113600000000000,mohtel,24,3238,60,31729,60,36284,15328,10171,82057,280,82057,69,498,498,147,147,0,0,0,0
1717200000000000000,mohtel,24,3243,95,31824,95,36379,15328,10171,82407,350,82407,69,498,498,147,147,0,0,0,0
1717286400000000000,mohtel,24,3247,60,31884,60,36439,15348,10231,82627,220,82627,70,498,498,147,147,0,0,0,0
1717372800000000000,mohtel,24,3251,40,31924,40,36479,15348,10231,82777,150,82777,70,498,498,147,147,0,0,0,0
1717459200000000000,mohtel,24,3258,71,31995,71,36550,15348,10231,82959,182,82959,70,498,498,147,147,0,0,0,0
1717545600000000000,mohtel,24,3262,36,32031,36,36586,15348,10231,83074,115,83074,70,498,498,147,147,0,0,0,0
1717632000000000000,mohtel,24,3268,68,32099,68,36654,15348,10231,83309,235,83309,70,498,498,147,147,0,0,0,0
1717718400000000000,mohtel,24,3276,77,32176,77,36731,15517,10279,83530,221,83530,70,498,498,147,147,0,0,0,0
1717804800000000000,mohtel,24,3281,70,32246,70,36801,15517,10279,83680,150,83680,70,498,498,147,147,0,0,0,0
1717891200000000000,mohtel,24,3289,283,32529,283,37084,15517,10279,84494,814,84494,70,498,498,150,150,0,0,0,0
1717977600000000000,mohtel,24,3294,40,32569,40,37124,15517,10279,84712,218,84712,70,498,498,150,150,0,0,0,0
1718064000000000000,mohtel,24,3297,40,32609,40,37164,15517,10279,84832,120,84832,70,498,498,150,150,0,0,0,0
1718150400000000000,mohtel,24,3300,38,32647,38,37202,15694,10367,84932,100,84932,70,498,498,150,150,0,0,0,0
1718236800000000000,mohtel,24,3303,30,32677,30,37232,15694,10367,85037,105,85037,70,498,498,150,150,0,0,0,0
1718323200000000000,mohtel,24,3307,34,32711,34,37266,15694,10367,85102,65,85102,70,498,498,150,150,0,0,0,0
1718409600000000000,mohtel,24,3310,30,32741,30,37296,15694,10367,85197,95,85197,70,498,498,150,150,0,0,0,0
1718496000000000000,mohtel,24,3313,41,32782,41,37337,15694,10367,85299,102,85299,70,498,498,150,150,0,0,0,0
1718582400000000000,mohtel,24,3315,10,32792,10,37347,15747,10406,85372,73,85372,70,498,498,151,151,0,0,0,0
1718668800000000000,mohtel,24,3318,25,32817,25,37372,15747,10406,85452,80,85452,70,498,498,151,151,0,0,0,0
1718755200000000000,mohtel,24,3321,24,32841,24,37396,15747,10406,85523,71,85523,70,498,498,151,151,0,0,0,0
1718841600000000000,mohtel,24,3325,35,32876,35,37431,15747,10406,85653,130,85653,70,498,498,151,151,0,0,0,0
1718928000000000000,mohtel,24,3328,19,32895,19,37450,15747,10406,85742,89,85742,70,498,498,151,151,0,0,0,0
1719014400000000000,mohtel,24,3331,101,32996,101,37551,15821,10475,85911,169,85911,70,499,499,152,152,0,0,0,0
1719100800000000000,mohtel,24,3334,47,33043,47,37598,15821,10475,86032,121,86032,70,499,499,152,152,0,0,0,0
1719187200000000000,mohtel,24,3334,28,33071,28,37626,15821,10475,86098,66,86098,70,499,499,152,152,0,0,0,0
1719273600000000000,mohtel,24,3337,32,33103,32,37658,15821,10475,86237,139,86237,70,499,499,152,152,0,0,0,0
1719360000000000000,mohtel,24,3341,60,33163,60,37718,15821,10475,86377,140,86377,70,499,499,152,152,0,0,0,0
1719446400000000000,mohtel,24,3344,47,33210,47,37765,15882,10538,86429,52,86429,74,500,500,152,152,0,0,0,0
1719532800000000000,mohtel,24,3348,29,33239,29,37794,15882,10538,86634,205,86634,74,500,500,152,152,0,0,0,0
1719619200000000000,mohtel,24,3351,40,33279,40,37834,15882,10538,86858,224,86858,74,500,500,152,152,0,0,0,0
1719705600000000000,mohtel,24,3354,43,33322,43,37877,15882,10538,86969,111,86969,74,500,500,152,152,0,0,0,0
1719792000000000000,mohtel,24,3356,23,33345,23,37900,15882,10538,87060,91,87060,74,500,500,153,153,0,0,0,0
1719878400000000000,mohtel,24,3359,25,33370,25,37925,15919,10569,87141,81,87141,75,500,500,153,153,0,0,0,0
1719964800000000000,mohtel,24,3362,28,33398,28,37953,15919,10569,87266,125,87266,75,500,500,153,153,0,0,0,0
1720051200000000000,mohtel,24,3366,58,33456,58,38011,15919,10569,87445,179,87445,75,500,500,153,153,0,0,0,0
1720137600000000000,mohtel,24,3370,58,33514,58,38069,15919,10569,87605,160,87605,75,500,500,153,153,0,0,0,0
1720224000000000000,mohtel,24,3373,29,33543,29,38098,15919,10569,87705,100,87705,75,500,500,158,158,0,0,0,0
1720310400000000000,mohtel,24,3376,55,33598,55,38153,15983,10637,87828,123,87828,75,500,500,158,158,0,0,0,0
1720396800000000000,mohtel,24,3379,40,33638,40,38193,15983,10637,87903,75,87903,75,500,500,158,158,0,0,0,0
1720483200000000000,mohtel,24,3382,50,33688,50,38243,15983,10637,88033,130,88033,75,500,500,158,158,0,0,0,0
1720569600000000000,mohtel,24,3386,52,33740,52,38295,15983,10637,88241,208,88241,75,500,500,158,158,0,0,0,0
1720656000000000000,mohtel,24,3388,50,33790,50,38345,16054,10700,88295,54,88295,75,500,500,158,158,0,0,0,0
1720742400000000000,mohtel,24,3391,37,33827,37,38382,16054,10700,88352,57,88352,75,500,500,158,158,0,0,0,0
1720828800000000000,mohtel,24,3395,61,33888,61,38443,16054,10700,88481,129,88481,75,500,500,158,158,0,0,0,0
1720915200000000000,mohtel,24,3399,141,34029,141,38584,16054,10700,88881,400,88881,75,500,500,158,158,0,0,0,0
1721001600000000000,mohtel,24,3402,80,34109,80,38664,16054,10700,89097,216,89097,75,500,500,158,158,0,0,0,0
1721088000000000000,mohtel,24,3404,49,34158,49,38713,16054,10700,89166,69,89166,75,500,500,160,160,0,0,0,0
1721174400000000000,mohtel,24,3408,81,34239,81,38794,16172,10798,89364,198,89364,79,500,500,160,160,0,0,0,0
1721260800000000000,mohtel,24,3411,54,34293,54,38848,16172,10798,89459,95,89459,79,500,500,160,160,0,0,0,0
1721347200000000000,mohtel,24,3414,34,34327,34,38882,16172,10798,89568,109,89568,79,500,500,160,160,0,0,0,0
1721433600000000000,mohtel,24,3418,37,34364,37,38919,16172,10798,89622,54,89622,79,500,500,161,161,0,0,0,0
1721520000000000000,mohtel,24,3422,64,34428,64,38983,16172,10798,89727,105,89727,79,500,500,162,162,0,0,0,0
1721606400000000000,mohtel,24,3425,23,34451,23,39006,16251,10859,89818,91,89818,79,500,500,163,163,0,0,0,0
1721692800000000000,mohtel,24,3433,84,34535,84,39090,16251,10859,90147,329,90147,79,500,500,163,163,0,0,0,0
1721779200000000000,mohtel,24,3436,55,34590,55,39145,16251,10859,90257,110,90257,79,500,500,163,163,0,0,0,0
1721865600000000000,mohtel,24,3439,30,34620,30,39175,16251,10859,90403,146,90403,79,500,500,163,163,0,0,0,0
1721952000000000000,mohtel,24,3439,42,34662,42,39217,16251,10859,90486,83,90486,79,500,500,163,163,0,0,0,0
1722038400000000000,mohtel,24,3443,41,34703,41,39258,16251,10921,90589,103,90589,79,885,885,163,163,0,0,0,0
1722124800000000000,mohtel,24,3446,66,34769,66,39324,16251,10921,90830,241,90830,79,885,885,163,163,0,0,0,0
1722211200000000000,mohtel,24,3449,39,34808,39,39363,16251,10921,90923,93,90923,79,885,885,163,163,0,0,0,0
1722297600000000000,mohtel,24,3452,37,34845,37,39400,16251,10921,90996,73,90996,79,885,885,163,163,0,0,0,0
1722384000000000000,mohtel,24,3455,45,34890,45,39445,16251,10921,91073,77,91073,79,885,885,163,163,0,0,0,0
1722470400000000000,mohtel,24,3457,35,34925,35,39480,16314,10980,91128,55,91128,79,885,885,165,165,0,0,0,0
1722556800000000000,mohtel,24,3460,39,34964,39,39519,16314,10980,91218,90,91218,79,885,885,165,165,0,0,0,0
1722643200000000000,mohtel,24,3463,31,34995,31,39550,16314,10980,91280,62,91280,79,885,885,165,165,0,0,0,0
1722729600000000000,mohtel,24,3465,33,35028,33,39583,16314,10980,91398,118,91398,79,885,885,165,165,0,0,0,0
1722816000000000000,mohtel,24,3468,40,35068,40,39623,16314,10980,91469,71,91469,79,885,885,165,165,0,0,0,0
1722902400000000000,mohtel,24,3471,30,35098,30,39653,16365,11012,91535,66,91535,79,885,885,166,166,0,0,0,0
1722988800000000000,mohtel,24,3473,24,35122,24,39677,16365,11012,91645,110,91645,79,885,885,166,166,0,0,0,0
1723075200000000000,mohtel,24,3477,22,35144,22,39699,16365,11012,91722,77,91722,79,885,885,166,166,0,0,0,0
1723161600000000000,mohtel,24,3480,51,35195,51,39750,16365,11012,91862,140,91862,79,885,885,168,168,0,0,0,0
1723248000000000000,mohtel,24,3483,40,35235,40,39790,16365,11012,92002,140,92002,79,885,885,168,168,0,0,0,0
1723334400000000000,mohtel,0,3483,0,35235,0,39790,16365,11012,92002,0,92002,79,885,885,168,168,0,0,0,0
1723420800000000000,mohtel,48,3486,107,35342,107,39897,16456,11088,92152,150,92152,79,885,885,168,168,0,0,0,0
1723507200000000000,mohtel,24,3488,32,35374,32,39929,16456,11088,92240,88,92240,79,885,885,168,168,0,0,0,0
1723593600000000000,mohtel,24,3490,36,35410,36,39965,16456,11088,92294,54,92294,79,885,885,168,168,0,0,0,0
1723680000000000000,mohtel,24,3493,40,35450,40,40005,16456,11088,92401,107,92401,79,885,885,168,168,0,0,0,0
1723766400000000000,mohtel,0,3493,0,35450,0,40005,16456,11088,92401,0,92401,79,885,885,168,168,0,0,0,0
1723852800000000000,mohtel,48,3498,69,35519,69,40074,16456,11088,92537,136,92537,79,885,885,168,168,0,0,0,0
1723939200000000000,mohtel,24,3500,25,35544,25,40099,16456,11088,92609,72,92609,79,885,885,168,168,0,0,0,0
1724025600000000000,mohtel,24,3503,40,35584,40,40139,16456,11088,92743,134,92743,79,885,885,169,169,0,0,0,0
1724112000000000000,mohtel,24,3506,34,35618,34,40173,16456,11088,92857,114,92857,79,885,885,169,169,0,0,0,0
1724198400000000000,mohtel,24,3510,50,35668,50,40223,16456,11088,92981,124,92981,79,885,885,170,170,0,0,0,0
1724284800000000000,mohtel,24,3514,42,35710,42,40265,16456,11088,93144,163,93144,79,885,885,170,170,0,0,0,0
1724371200000000000,mohtel,0,3514,0,35710,0,40265,16456,11088,93144,0,93144,79,885,885,170,170,0,0,0,0
1724457600000000000,mohtel,48,3519,69,35779,69,40334,16456,11088,93356,212,93356,79,885,885,170,170,0,0,0,0
1724544000000000000,mohtel,24,3522,71,35850,71,40405,16456,11088,93468,112,93468,79,885,885,170,170,0,0,0,0
1724630400000000000,mohtel,24,3524,30,35880,30,40435,16589,11207,93534,66,93534,82,885,885,170,170,0,0,0,0
1724716800000000000,mohtel,24,3524,41,35921,41,40476,16589,11207,93534,113,93647,82,885,885,171,171,0,0,0,0
1724803200000000000,mohtel,24,3528,58,35979,58,40534,16589,11207,93778,131,93778,82,885,885,172,172,0,0,0,0
1724889600000000000,mohtel,24,3532,68,36047,68,40602,16589,11207,93855,77,93855,82,885,885,172,172,0,0,0,0
1724976000000000000,mohtel,0,3532,0,36047,0,40602,16589,11207,93855,0,93855,82,885,885,172,172,0,0,0,0
1725062400000000000,mohtel,48,3537,89,36136,89,40691,16673,11269,94060,205,94060,82,885,885,172,172,0,0,0,0
1725148800000000000,mohtel,24,3540,47,36183,47,40738,16673,11269,94154,94,94154,82,885,885,172,172,0,0,0,0
1725235200000000000,mohtel,24,3543,48,36231,48,40786,16673,11269,94224,70,94224,82,885,885,172,172,0,0,0,0
1725321600000000000,mohtel,24,3546,33,36264,33,40819,16673,11269,94291,67,94291,82,885,885,172,172,0,0,0,0
1725408000000000000,mohtel,24,3549,42,36306,42,40861,16673,11269,94398,107,94398,82,885,885,172,172,0,0,0,0
1725494400000000000,mohtel,24,3551,17,36323,17,40878,16673,11269,94454,56,94454,82,885,885,172,172,0,0,0,0
1725580800000000000,mohtel,0,3551,0,36323,0,40878,16673,11269,94454,0,94454,82,885,885,172,172,0,0,0,0
1725667200000000000,mohtel,48,3555,61,36384,61,40939,16673,11269,94616,162,94616,82,885,885,172,172,0,0,0,0
1725753600000000000,mohtel,24,3558,33,36417,33,40972,16673,11269,94761,145,94761,82,885,885,172,172,0,0,0,0
1725840000000000000,mohtel,24,3560,16,36433,16,40988,16673,11269,94825,64,94825,82,885,885,172,172,0,0,0,0
1725926400000000000,mohtel,24,3563,32,36465,32,41020,16756,11346,94925,100,94925,82,885,885,172,172,0,0,0,0
1726012800000000000,mohtel,24,3567,64,36529,64,41084,16756,11346,95029,104,95029,82,885,885,172,172,0,0,0,0
1726099200000000000,mohtel,24,3570,34,36563,34,41118,16756,11346,95125,96,95125,82,885,885,172,172,0,0,0,0
1726185600000000000,mohtel,0,3570,0,36563,0,41118,16756,11346,95125,0,95125,82,885,885,172,172,0,0,0,0
1726272000000000000,mohtel,48,3574,64,36627,64,41182,16756,11346,95280,155,95280,82,885,885,172,172,0,0,0,0
1726358400000000000,mohtel,24,3577,24,36651,24,41206,16795,11378,95337,57,95337,83,885,885,173,173,0,0,0,0
1726444800000000000,mohtel,24,3580,20,36671,20,41226,16795,11378,95413,76,95413,83,885,885,173,173,0,0,0,0
1726531200000000000,mohtel,24,3583,26,36697,26,41252,16795,11378,95497,84,95497,83,885,885,173,173,0,0,0,0
1726617600000000000,mohtel,24,3585,20,36717,20,41272,16795,11378,95551,54,95551,83,885,885,173,173,0,0,0,0
1726704000000000000,mohtel,0,3585,0,36717,0,41272,16795,11378,95551,0,95551,83,885,885,173,173,0,0,0,0
1726790400000000000,mohtel,0,3585,0,36717,0,41272,16795,11378,95551,0,95551,83,885,885,173,173,0,0,0,0
1726876800000000000,mohtel,24,3597,119,36836,119,41391,16795,11378,95760,209,95760,83,885,885,173,173,0,0,0,0
1726963200000000000,mohtel,24,3600,40,36876,40,41431,16795,11378,95818,58,95818,83,885,885,173,173,0,0,0,0
1727049600000000000,mohtel,24,3603,24,36900,24,41455,16795,11378,95878,60,95878,83,885,885,173,173,0,0,0,0
1727136000000000000,mohtel,24,3606,12,36912,12,41467,16795,11378,95921,43,95921,83,885,885,173,173,0,0,0,0
1727222400000000000,mohtel,24,3610,28,36940,28,41495,16859,11429,96006,85,96006,85,986,986,173,173,0,0,0,0
1727308800000000000,mohtel,24,3614,39,36979,39,41534,16859,11429,96092,86,96092,85,986,986,173,173,0,0,0,0
1727395200000000000,mohtel,0,3614,0,36979,0,41534,16859,11429,96092,0,96092,85,986,986,173,173,0,0,0,0
1727481600000000000,mohtel,48,3618,52,37031,52,41586,16859,11429,96210,118,96210,85,986,986,173,173,0,0,0,0
1727568000000000000,mohtel,24,3618,9,37040,9,41595,16859,11429,96251,41,96251,85,986,986,173,173,0,0,0,0
1727654400000000000,mohtel,24,3620,20,37060,20,41615,16891,11458,96359,108,96359,85,986,986,174,174,0,0,0,0
1727740800000000000,mohtel,24,3624,23,37083,23,41638,16891,11458,96460,101,96460,85,986,986,174,174,0,0,0,0
1727827200000000000,mohtel,24,3629,51,37134,51,41689,16891,11458,96625,165,96625,85,986,986,174,174,0,0,0,0
1727913600000000000,mohtel,24,3637,99,37233,99,41788,16891,11458,96794,169,96794,85,986,986,174,174,0,0,0,0
1728000000000000000,mohtel,24,3640,14,37247,14,41802,16891,11458,96844,50,96844,85,986,986,174,174,0,0,0,0
1728086400000000000,mohtel,24,3643,23,37270,23,41825,16891,11458,96910,66,96910,85,986,986,174,174,0,0,0,0
1728172800000000000,mohtel,24,3646,45,37315,45,41870,16927,11487,97166,256,97166,85,986,986,175,175,0,0,0,0
1728259200000000000,mohtel,24,3650,39,37354,39,41909,16927,11487,97303,137,97303,85,986,986,175,175,0,0,0,0
1728345600000000000,mohtel,24,3658,56,37410,56,41965,16927,11487,97590,287,97590,85,986,986,175,175,0,0,0,0
1728432000000000000,mohtel,24,3661,45,37455,45,42010,16927,11487,97720,130,97720,85,986,986,176,176,0,0,0,0
1728518400000000000,mohtel,24,3666,55,37510,55,42065,16927,11487,97886,166,97886,85,986,986,176,176,0,0,0,0
1728604800000000000,mohtel,24,3670,61,37571,61,42126,16927,11487,98117,231,98117,85,986,986,176,176,0,0,0,0
1728691200000000000,mohtel,24,3675,49,37620,49,42175,16927,11487,98336,219,98336,85,986,986,176,176,0,0,0,0
1728777600000000000,mohtel,24,3679,52,37672,52,42227,16927,11487,98464,128,98464,85,986,986,176,176,0,0,0,0
1728864000000000000,mohtel,24,3683,62,37734,62,42289,16927,11487,98684,220,98684,85,986,986,177,177,0,0,0,0
1728950400000000000,mohtel,24,3687,55,37789,55,42344,17029,11585,99013,329,99013,85,986,986,177,177,0,0,0,0
1729036800000000000,mohtel,24,3691,65,37854,65,42409,17029,11585,99153,140,99153,85,986,986,177,177,0,0,0,0
1729123200000000000,mohtel,24,3695,29,37883,29,42438,17029,11585,99246,93,99246,85,986,986,177,177,0,0,0,0
1729209600000000000,mohtel,24,3699,62,37945,62,42500,17029,11585,99546,300,99546,85,986,986,177,177,0,0,0,0
1729296000000000000,mohtel,24,3702,19,37964,19,42519,17029,11585,99637,91,99637,85,986,986,177,177,0,0,0,0
1729382400000000000,mohtel,24,3709,84,38048,84,42603,17029,11585,99795,158,99795,85,986,986,177,177,0,0,0,0
1729468800000000000,mohtel,0,3709,0,38048,0,42603,17029,11585,99795,0,99795,85,986,986,177,177,0,0,0,0
1729555200000000000,mohtel,48,3716,115,38163,115,42718,17029,11585,100282,487,100282,85,986,986,177,177,0,0,0,0
1729641600000000000,mohtel,24,3722,74,38237,74,42792,17029,11585,100412,130,100412,85,986,986,177,177,0,0,0,0
1729728000000000000,mohtel,24,3726,55,38292,55,42847,17029,11585,100544,132,100544,85,986,986,177,177,0,0,0,0
1729814400000000000,mohtel,0,3726,0,38292,0,42847,17210,11742,100544,0,100544,85,1047,1047,177,177,0,0,0,0
1729900800000000000,mohtel,48,3733,77,38369,77,42924,17210,11742,100833,289,100833,85,1047,1047,177,177,0,0,0,0
1729987200000000000,mohtel,0,3733,0,38369,0,42924,17210,11742,100833,0,100833,85,1047,1047,182,182,0,0,0,0
1730073600000000000,mohtel,48,3738,96,38465,96,43020,17210,11742,101110,277,101110,85,1047,1047,182,182,0,0,0,0
1730160000000000000,mohtel,24,3742,41,38506,41,43061,17210,11742,101223,113,101223,85,1047,1047,182,182,0,0,0,0
1730246400000000000,mohtel,24,3747,102,38608,102,43163,17289,11815,101510,287,101510,85,1047,1047,182,182,0,0,0,0
1730332800000000000,mohtel,24,3753,41,38649,41,43204,17289,11815,101641,131,101641,85,1047,1047,182,182,0,0,0,0
1730419200000000000,mohtel,24,3756,55,38704,55,43259,17289,11815,101827,186,101827,85,1047,1047,182,182,0,0,0,0
1730505600000000000,mohtel,24,3763,55,38759,55,43314,17289,11815,102019,192,102019,85,1047,1047,183,183,0,0,0,0
1730592000000000000,mohtel,24,3767,27,38786,27,43341,17289,11815,102105,86,102105,85,1047,1047,183,183,0,0,0,0
1730678400000000000,mohtel,24,3770,33,38819,33,43374,17289,11815,102261,156,102261,85,1047,1047,183,183,0,0,0,0
1730764800000000000,mohtel,24,3773,17,38836,17,43391,17289,11815,102347,86,102347,85,1047,1047,183,183,0,0,0,0
1730851200000000000,mohtel,0,3773,0,38836,0,43391,17289,11815,102347,0,102347,85,1047,1047,183,183,0,0,0,0
1730937600000000000,mohtel,48,3779,78,38914,78,43469,17289,11815,102561,214,102561,85,1047,1047,183,183,0,0,0,0
1731024000000000000,mohtel,24,3782,39,38953,39,43508,17289,11815,102684,123,102684,85,1047,1047,183,183,0,0,0,0
1731110400000000000,mohtel,24,3786,44,38997,44,43552,17385,11891,102765,81,102765,85,1054,1054,188,188,0,0,0,0
1731196800000000000,mohtel,24,3789,51,39048,51,43603,17385,11891,102929,164,102929,85,1054,1054,188,188,0,0,0,0
1731283200000000000,mohtel,0,3789,0,39048,0,43603,17385,11891,102929,0,102929,85,1054,1054,188,188,0,0,0,0
1731369600000000000,mohtel,48,3794,62,39110,62,43665,17385,11891,103076,147,103076,85,1054,1054,188,188,0,0,0,0
1731456000000000000,mohtel,24,3801,47,39157,47,43712,17385,11891,103258,182,103258,85,1054,1054,188,188,0,0,0,0
1731542400000000000,mohtel,24,3804,24,39181,24,43736,17385,11891,103370,112,103370,85,1054,1054,188,188,0,0,0,0
1731628800000000000,mohtel,24,3807,28,39209,28,43764,17385,11891,103490,120,103490,85,1054,1054,188,188,0,0,0,0
1731715200000000000,mohtel,24,3810,35,39244,35,43799,17385,11891,103601,111,103601,85,1054,1054,188,188,0,0,0,0
1731801600000000000,mohtel,24,3816,47,39291,47,43846,17385,11891,103740,139,103740,85,1054,1054,188,188,0,0,0,0
1731888000000000000,mohtel,24,3820,76,39367,76,43922,17385,11891,103898,158,103898,85,1054,1054,188,188,0,0,0,0
1731974400000000000,mohtel,24,3823,50,39417,50,43972,17492,11979,104008,110,104008,86,1054,1054,188,188,0,0,0,0
1732060800000000000,mohtel,24,3825,13,39430,13,43985,17492,11979,104092,84,104092,86,1054,1054,188,188,0,0,0,0
1732147200000000000,mohtel,24,3830,71,39501,71,44056,17492,11979,104268,176,104268,86,1054,1054,188,188,0,0,0,0
1732233600000000000,mohtel,0,3830,0,39501,0,44056,17492,11979,104268,0,104268,86,1054,1054,188,188,0,0,0,0
1732320000000000000,mohtel,48,3837,120,39621,120,44176,17492,11979,104473,205,104473,86,1054,1054,189,189,0,0,0,0
1732406400000000000,mohtel,24,3841,35,39656,35,44211,17492,11979,104567,94,104567,86,1054,1054,189,189,0,0,0,0
1732492800000000000,mohtel,24,3843,24,39680,24,44235,17492,11979,104638,71,104638,86,1054,1054,189,189,0,0,0,0
1732579200000000000,mohtel,24,3846,14,39694,14,44249,17492,11979,104746,108,104746,86,1054,1054,189,189,0,0,0,0
1732665600000000000,mohtel,24,3849,33,39727,33,44282,17492,11979,104880,134,104880,86,1054,1054,190,190,0,0,0,0
1732752000000000000,mohtel,24,3852,48,39775,48,44330,17492,11979,104933,53,104933,86,1054,1054,190,190,0,0,0,0
1732838400000000000,mohtel,24,3855,33,39808,33,44363,17581,12048,105070,137,105070,87,1055,1055,190,190,0,0,0,0
1732924800000000000,mohtel,24,3859,19,39827,19,44382,17581,12048,105142,72,105142,87,1055,1055,190,190,0,0,0,0
1733011200000000000,mohtel,24,3865,47,39874,47,44429,17581,12048,105250,108,105250,87,1055,1055,192,192,0,0,0,0
1733097600000000000,mohtel,24,3869,37,39911,37,44466,17581,12048,105358,108,105358,87,1055,1055,192,192,0,0,0,0
1733184000000000000,mohtel,24,3871,36,39947,36,44502,17581,12048,105454,96,105454,87,1055,1055,192,192,0,0,0,0
1733270400000000000,mohtel,24,3874,30,39977,30,44532,17581,12048,105538,84,105538,87,1055,1055,192,192,0,0,0,0
1733356800000000000,mohtel,24,3879,48,40025,48,44580,17581,12048,105739,201,105739,87,1055,1055,192,192,0,0,0,0
1733443200000000000,mohtel,24,3882,32,40057,32,44612,17581,12048,105834,95,105834,87,1055,1055,192,192,0,0,0,0
1733529600000000000,mohtel,24,3886,52,40109,52,44664,17581,12048,105976,142,105976,87,1055,1055,192,192,0,0,0,0
1733616000000000000,mohtel,24,3890,44,40153,44,44708,17581,12048,106050,74,106050,87,1055,1055,192,192,0,0,0,0
1733702400000000000,mohtel,24,3893,50,40203,50,44758,17712,12136,106134,84,106134,88,1059,1059,192,192,0,0,0,0
1733788800000000000,mohtel,24,3897,28,40231,28,44786,17712,12136,106188,54,106188,88,1059,1059,192,192,0,0,0,0
1733875200000000000,mohtel,24,3899,19,40250,19,44805,17712,12136,106257,69,106257,88,1059,1059,193,193,0,0,0,0
1733961600000000000,mohtel,24,3902,30,40280,30,44835,17712,12136,106356,99,106356,88,1059,1059,193,193,0,0,0,0
1734048000000000000,mohtel,24,3905,40,40320,40,44875,17712,12136,106454,98,106454,88,1059,1059,193,193,0,0,0,0
1734134400000000000,mohtel,24,3907,55,40375,55,44930,17712,12136,106624,170,106624,88,1059,1059,193,193,0,0,0,0
1734220800000000000,mohtel,24,3912,46,40421,46,44976,17712,12136,106759,135,106759,88,1059,1059,196,196,0,0,0,0
1734307200000000000,mohtel,24,3919,52,40473,52,45028,17712,12136,106962,203,106962,88,1059,1059,196,196,0,0,0,0
1734393600000000000,mohtel,24,3922,31,40504,31,45059,17712,12136,107041,79,107041,88,1059,1059,196,196,0,0,0,0
1734480000000000000,mohtel,24,3925,38,40542,38,45097,17712,12136,107244,203,107244,88,1059,1059,196,196,0,0,0,0
1734566400000000000,mohtel,24,3929,32,40574,32,45129,17803,12224,107338,94,107338,94,1060,1060,196,196,0,0,0,0
1734652800000000000,mohtel,24,3932,77,40651,77,45206,17803,12224,107512,174,107512,94,1060,1060,196,196,0,0,0,0
1734739200000000000,mohtel,24,3935,21,40672,21,45227,17803,12224,107573,61,107573,94,1060,1060,196,196,0,0,0,0
1734825600000000000,mohtel,24,3939,32,40704,32,45259,17803,12224,107627,54,107627,94,1060,1060,196,196,0,0,0,0
1734912000000000000,mohtel,24,3944,58,40762,58,45317,17803,12224,107713,86,107713,94,1060,1060,196,196,0,0,0,0
1734998400000000000,mohtel,24,3947,21,40783,21,45338,17803,12224,107764,51,107764,94,1060,1060,196,196,0,0,0,0
1735084800000000000,mohtel,24,3950,23,40806,23,45361,17803,12224,107803,39,107803,94,1060,1060,196,196,0,0,0,0
1735171200000000000,mohtel,24,3953,38,40844,38,45399,17803,12224,107940,137,107940,94,1060,1060,196,196,0,0,0,0
1735257600000000000,mohtel,24,3956,37,40881,37,45436,17803,12224,108038,98,108038,94,1060,1060,196,196,0,0,0,0
1735344000000000000,mohtel,24,3958,48,40929,48,45484,17803,12224,108090,52,108090,94,1060,1060,196,196,0,0,0,0
1735430400000000000,mohtel,24,3958,30,40959,30,45514,17818,12287,108189,99,108189,94,1068,1068,201,201,0,0,0,0
1735516800000000000,mohtel,24,3961,27,40986,27,45541,17818,12287,108338,149,108338,94,1068,1068,201,201,0,0,0,0
1735603200000000000,mohtel,0,3961,0,40986,0,45541,17818,12287,108338,0,108338,94,1068,1068,201,201,0,0,0,0
1735689600000000000,mohtel,48,3963,12,40998,12,45553,17818,12287,108379,41,108379,94,1068,1068,201,201,0,0,0,0
1735776000000000000,mohtel,24,3968,28,41026,28,45581,17818,12287,108438,59,108438,94,1068,1068,201,201,0,0,0,0
1735862400000000000,mohtel,24,3976,77,41103,77,45658,17818,12287,108583,145,108583,94,1068,1068,202,202,0,0,0,0
1735948800000000000,mohtel,24,3980,59,41162,59,45717,17818,12287,108856,273,108856,94,1068,1068,202,202,0,0,0,0
1736035200000000000,mohtel,24,3985,88,41250,88,45805,17818,12287,109064,208,109064,94,1068,1068,202,202,0,0,0,0
1736121600000000000,mohtel,24,3988,49,41299,49,45854,17818,12287,109139,75,109139,94,1068,1068,202,202,0,0,0,0
1736208000000000000,mohtel,24,3991,31,41330,31,45885,17818,12287,109196,57,109196,94,1068,1068,202,202,0,0,0,0
1736294400000000000,mohtel,24,3997,51,41381,51,45936,17841,12298,109274,78,109274,94,1068,1068,202,202,0,0,0,0
1736380800000000000,mohtel,24,4000,70,41451,70,46006,17841,12298,109378,104,109378,94,1068,1068,202,202,0,0,0,0
1736467200000000000,mohtel,0,4000,0,41451,0,46006,17841,12298,109378,0,109378,94,1068,1068,203,203,0,0,0,0
1736553600000000000,mohtel,48,4005,531,41982,531,46537,17841,12298,109571,193,109571,94,1068,1068,203,203,0,0,0,0
1736640000000000000,mohtel,24,4007,28,42010,28,46565,17841,12298,109660,89,109660,94,1068,1068,203,203,0,0,0,0
1736726400000000000,mohtel,24,4009,19,42029,19,46584,17841,12298,109731,71,109731,94,1068,1068,203,203,0,0,0,0
1736812800000000000,mohtel,24,4013,61,42090,61,46645,17841,12298,110012,281,110012,94,1068,1068,204,204,0,0,0,0
1736899200000000000,mohtel,24,4019,62,42152,62,46707,17841,12298,110265,253,110265,94,1068,1068,204,204,0,0,0,0
1736985600000000000,mohtel,24,4027,81,42233,81,46788,17841,12298,110453,188,110453,94,1068,1068,204,204,0,0,0,0
1737072000000000000,mohtel,24,4031,88,42321,88,46876,17841,12298,110642,189,110642,94,1068,1068,204,204,0,0,0,0
1737158400000000000,mohtel,24,10100,23,42344,23,46899,17861,12316,110725,83,110725,94,1155,1155,205,205,0,0,0,0
1737244800000000000,mohtel,24,10100,14,42358,14,46913,17861,12316,110750,25,110750,94,1155,1155,205,205,0,0,0,0
1737331200000000000,mohtel,24,10100,122,42480,122,47035,17861,12316,111091,341,111091,94,1155,1155,205,205,0,0,0,0
1737417600000000000,mohtel,24,10100,72,42552,72,47107,17861,12316,111147,56,111147,94,1155,1155,205,205,0,0,0,0
1737504000000000000,mohtel,24,10100,54,42606,54,47161,17861,12316,111166,19,111166,94,1155,1155,205,205,0,0,0,0
1737590400000000000,mohtel,24,10100,122,42728,122,47283,17861,12316,111472,306,111472,94,1155,1155,205,205,120,0,2,0
1737676800000000000,mohtel,0,10100,0,42728,0,47283,17861,12316,111472,0,111472,94,1155,1155,205,205,0,0,0,0
1737763200000000000,mohtel,0,10100,0,42728,0,47283,17861,12316,111472,0,111472,94,1155,1155,205,205,0,0,0,0
1737849600000000000,mohtel,24,10100,23,42751,23,47306,17861,12316,111483,11,111483,94,1155,1155,205,205,14,5,4,0
1737936000000000000,mohtel,24,10100,11,42762,11,47317,17861,12316,111494,11,111494,94,1155,1155,205,205,9,2,0,0
1738022400000000000,mohtel,24,10100,37,42799,37,47354,17861,12316,111563,69,111563,94,1155,1155,205,205,37,0,0,0
1738108800000000000,mohtel,24,10100,63,42862,63,47417,17861,12316,111571,8,111571,94,1155,1155,205,205,59,2,2,0
1738195200000000000,mohtel,24,10100,43,42905,43,47460,17861,12316,111580,9,111580,94,1155,1155,205,205,42,1,0,0
1738281600000000000,mohtel,24,10100,0,42905,0,47460,17861,12316,111580,0,111580,94,1155,1155,205,205,0,0,0,0
1738368000000000000,mohtel,24,10100,27,42932,27,47487,17861,12316,111588,8,111588,94,1155,1155,205,205,24,2,1,0
1738454400000000000,mohtel,24,10100,11,42943,11,47498,17861,12316,111592,4,111592,94,1155,1155,205,205,9,2,0,0
1738540800000000000,mohtel,24,10100,20,42963,20,47518,17861,12316,111612,20,111612,94,1155,1155,205,205,18,1,1,0
1738627200000000000,mohtel,24,10100,22,42985,22,47540,17861,12316,111618,6,111618,94,1155,1155,205,205,20,2,0,0
1738713600000000000,mohtel,24,10100,12,42997,12,47552,17861,12316,111629,11,111629,94,1155,1155,205,205,8,4,0,0
1738800000000000000,mohtel,24,10100,31,43028,31,47583,17861,12316,111633,4,111633,94,1155,1155,205,205,28,1,2,0
1738886400000000000,mohtel,0,10100,0,43028,0,47583,17861,12316,111633,0,111633,94,1155,1155,205,205,0,0,0,0
1738972800000000000,mohtel,48,10100,598,43626,598,48181,17861,12316,111638,5,111638,94,1155,1155,205,205,22,0,4,572
1739059200000000000,mohtel,24,10100,8,43634,8,48189,17861,12316,111640,2,111640,94,1155,1155,205,205,7,0,1,0
1739145600000000000,mohtel,24,10100,19,43653,19,48208,17861,12316,111655,15,111655,94,1155,1155,205,205,14,2,3,0
1739232000000000000,mohtel,24,10100,11,43664,11,48219,17861,12316,111665,10,111665,94,1155,1155,205,205,8,0,3,0
1739318400000000000,mohtel,24,10100,3,43667,3,48222,17861,12316,111674,9,111674,94,1155,1155,205,205,2,0,1,0
1739404800000000000,mohtel,24,10100,17,43684,17,48239,17861,12316,111676,2,111676,94,1155,1155,205,205,14,0,3,0
1739491200000000000,mohtel,0,10100,0,43684,0,48239,17861,12316,111676,0,111676,94,1155,1155,205,205,0,0,0,0
1739577600000000000,mohtel,48,10100,25,43709,25,48264,17861,12316,111688,12,111688,94,1155,1155,205,205,0,0,25,0
1739664000000000000,mohtel,24,10100,7,43716,7,48271,17861,12316,111693,5,111693,94,1155,1155,205,205,6,0,1,0
1739750400000000000,mohtel,24,10100,13,43729,13,48284,17861,12316,111709,16,111709,94,1155,1155,205,205,9,0,4,0
1739836800000000000,mohtel,24,10100,7,43736,7,48291,17861,12316,111722,13,111722,94,1155,1155,205,205,6,0,1,0
1739923200000000000,mohtel,24,10100,6,43742,6,48297,17861,12316,111733,11,111733,94,1155,1155,205,205,2,1,3,0
1740009600000000000,mohtel,24,10100,22,43764,22,48319,17861,12316,111749,16,111749,94,1155,1155,205,205,22,0,0,0
1740096000000000000,mohtel,0,10100,0,43764,0,48319,17861,12316,111749,0,111749,94,1155,1155,205,205,0,0,0,0
1740182400000000000,mohtel,48,10100,10,43774,10,48329,17861,12316,111753,4,111753,94,1155,1155,205,205,7,1,2,0
1740268800000000000,mohtel,24,10100,10,43784,10,48339,17861,12316,111753,0,111753,94,1155,1155,205,205,0,0,10,0
1740355200000000000,mohtel,24,10100,7,43791,7,48346,17861,12316,111759,6,111759,94,1155,1155,205,205,5,0,2,0
1740441600000000000,mohtel,24,10100,2,43793,2,48348,17861,12316,111761,2,111761,94,1155,1155,205,205,1,0,1,0
1740528000000000000,mohtel,0,10100,0,43793,0,48348,17861,12316,111761,0,111761,94,1155,1155,205,205,0,0,0,0
1740614400000000000,mohtel,48,10100,17,43810,17,48365,17861,12316,111780,19,111780,94,1155,1155,205,205,0,0,17,0
1740700800000000000,mohtel,0,10100,0,43810,0,48365,17861,12316,111780,0,111780,94,1155,1155,205,205,0,0,0,0
1740787200000000000,mohtel,48,10100,23,43833,23,48388,17861,12316,111803,23,111803,94,1155,1155,205,205,21,0,2,0
1740873600000000000,mohtel,0,10100,0,43833,0,48388,17861,12316,111803,0,111803,94,1155,1155,205,205,0,0,0,0
1740960000000000000,mohtel,48,10100,9,43842,9,48397,17861,12316,111824,21,111824,94,1155,1155,205,205,4,0,5,0
1741046400000000000,mohtel,24,10100,8,43850,8,48405,17861,12316,111835,11,111835,94,1155,1155,205,205,7,1,0,0
1741132800000000000,mohtel,24,10100,35,43885,35,48440,17861,12316,111845,10,111845,94,1155,1155,205,205,30,1,4,0
1741219200000000000,mohtel,24,10100,6,43891,6,48446,17861,12316,111852,7,111852,94,1155,1155,205,205,0,0,6,0
1741305600000000000,mohtel,0,10100,0,43891,0,48446,17861,12316,111852,0,111852,94,1155,1155,205,205,0,0,0,0
1741392000000000000,mohtel,48,10100,7,43898,7,48453,17861,12316,111860,8,111860,94,1155,1155,205,205,1,0,6,0
1741478400000000000,mohtel,24,10100,5,43903,5,48458,17861,12316,111897,37,111897,94,1155,1155,205,205,0,0,5,0
1741564800000000000,mohtel,24,10100,9,43912,9,48467,17861,12316,111913,16,111913,94,1155,1155,205,205,5,0,4,0
1741651200000000000,mohtel,24,10100,36,43948,36,48503,17861,12316,111927,14,111927,94,1155,1155,205,205,32,0,4,0
1741737600000000000,mohtel,24,10100,12,43960,12,48515,17861,12316,111941,14,111941,94,1155,1155,205,205,5,0,7,0
1741824000000000000,mohtel,24,10100,9,43969,9,48524,17861,12316,111955,14,111955,94,1155,1155,205,205,7,0,2,0
1741910400000000000,mohtel,0,10100,0,43969,0,48524,17861,12316,111955,0,111955,94,1155,1155,205,205,0,0,0,0
1741996800000000000,mohtel,48,10100,19,43988,19,48543,17861,12316,111981,26,111981,94,1155,1155,205,205,12,0,7,0
1742083200000000000,mohtel,24,10100,29,44017,29,48572,17861,12316,112032,51,112032,94,1155,1155,205,205,15,0,14,0
1742169600000000000,mohtel,24,10100,5,44022,5,48577,17861,12316,112041,9,112041,94,1155,1155,205,205,3,1,1,0
1742256000000000000,mohtel,24,10100,436,44458,436,49013,17861,12316,112719,678,112719,94,1155,1155,205,205,0,0,436,0
1742342400000000000,mohtel,24,10100,604,45062,604,49617,17861,12316,112950,231,112950,94,1155,1155,205,205,0,0,70,534
1742428800000000000,mohtel,24,10100,85,45147,85,49702,17861,12316,113083,133,113083,94,1155,1155,205,205,0,0,85,0
1742515200000000000,mohtel,0,10100,0,45147,0,49702,17861,12316,113083,0,113083,94,1155,1155,205,205,0,0,0,0
1742601600000000000,mohtel,48,10100,45,45192,45,49747,17861,12316,113213,130,113213,94,1155,1155,205,205,2,0,43,0
1742688000000000000,mohtel,24,12000,274,45466,274,50021,17954,12365,113274,61,113274,105,1394,1394,206,206,2,0,39,233
1742774400000000000,mohtel,24,12000,61,45527,61,50082,17954,12365,113408,134,113408,105,1394,1394,206,206,4,0,57,0
1742860800000000000,mohtel,24,12000,62,45589,62,50144,17954,12365,113704,296,113704,105,1394,1394,206,206,0,0,62,0
1742947200000000000,mohtel,24,12000,39,45628,39,50183,17954,12365,113828,124,113828,105,1394,1394,206,206,1,0,38,0
1743033600000000000,mohtel,24,12000,25,45653,25,50208,17954,12365,113910,82,113910,105,1394,1394,206,206,0,0,25,0
1743120000000000000,mohtel,24,12000,43,45696,43,50251,17954,12365,114025,115,114025,105,1394,1394,206,206,2,0,41,0
1743206400000000000,mohtel,24,12000,26,45722,26,50277,17954,12365,114095,70,114095,105,1394,1394,206,206,1,0,25,0
1743292800000000000,mohtel,24,12000,53,45775,53,50330,17954,12365,114284,189,114284,105,1394,1394,206,206,0,0,53,0
1743379200000000000,mohtel,24,12000,27,45802,27,50357,17954,12365,114400,116,114400,111,1402,1402,206,206,0,0,27,0
1743465600000000000,mohtel,24,12000,42,45844,42,50399,17954,12365,114583,183,114583,111,1402,1402,209,209,1,0,41,0
1743552000000000000,mohtel,24,12000,24,45868,24,50423,17954,12365,114638,55,114638,111,1402,1402,209,209,0,0,24,0
1743638400000000000,mohtel,24,12000,100,45968,100,50523,17954,12365,114776,138,114776,111,1402,1402,209,209,3,0,97,0
1743724800000000000,mohtel,24,12000,86,46054,86,50609,17954,12365,115063,287,115063,111,1402,1402,209,209,0,0,86,0
1743811200000000000,mohtel,24,12000,60,46114,60,50669,17954,12365,115225,162,115225,111,1402,1402,209,209,0,0,60,0
1743897600000000000,mohtel,24,12000,26,46140,26,50695,17954,12365,115338,113,115338,111,1402,1402,209,209,0,0,26,0
1743984000000000000,mohtel,24,12000,57,46197,57,50752,17954,12365,115475,137,115475,111,1402,1402,210,210,0,0,57,0
1744070400000000000,mohtel,24,12000,58,46255,58,50810,17954,12365,115688,213,115688,111,1402,1402,210,210,0,0,58,0
1744156800000000000,mohtel,24,12000,36,46291,36,50846,17954,12365,115729,41,115729,111,1402,1402,211,211,3,0,33,0
1744243200000000000,mohtel,24,12000,40,46331,40,50886,17954,12365,115875,146,115875,111,1402,1402,211,211,0,0,40,0
1744329600000000000,mohtel,24,12000,26,46357,26,50912,17954,12365,115981,106,115981,111,1402,1402,211,211,6,0,20,0
1744416000000000000,mohtel,24,12000,21,46378,21,50933,17954,12365,116045,64,116045,111,1402,1402,211,211,0,0,21,0
1744502400000000000,mohtel,24,12000,11,46389,11,50944,17954,12365,116156,111,116156,111,1402,1402,211,211,0,0,11,0
1744588800000000000,mohtel,24,12000,39,46428,39,50983,17954,12365,116274,118,116274,111,1402,1402,211,211,1,0,38,0
1744675200000000000,mohtel,24,12000,17,46445,17,51000,17954,12365,116343,69,116343,111,1402,1402,211,211,0,0,17,0
1744761600000000000,mohtel,24,12000,25,46470,25,51025,17954,12365,116432,89,116432,111,1402,1402,211,211,3,0,22,0
1744848000000000000,mohtel,24,12000,40,46510,40,51065,17954,12365,116505,73,116505,111,1402,1402,211,211,1,0,39,0
1744934400000000000,mohtel,0,12000,0,46510,0,51065,18000,12400,116505,0,116505,113,1402,1402,211,211,0,0,0,0
1745020800000000000,mohtel,48,12000,92,46602,92,51157,18000,12400,116724,219,116724,113,1402,1402,211,211,0,0,92,0
1745107200000000000,mohtel,24,12000,44,46646,44,51201,18000,12400,116869,145,116869,113,1402,1402,211,211,0,0,44,0
1745193600000000000,mohtel,24,12000,39,46685,39,51240,18000,12400,116931,62,116931,113,1402,1402,211,211,2,0,37,0
1745280000000000000,mohtel,24,12000,26,46711,26,51266,18000,12400,116991,60,116991,113,1402,1402,211,211,0,0,26,0
1745366400000000000,mohtel,24,12000,39,46750,39,51305,18000,12400,117096,105,117096,113,1402,1402,211,211,1,0,38,0
1745452800000000000,mohtel,24,12000,50,46800,50,51355,18000,12400,117248,152,117248,113,1402,1402,211,211,2,0,48,0
1745539200000000000,mohtel,24,12000,84,46884,84,51439,18000,12400,117416,168,117416,113,1402,1402,212,212,6,0,78,0
1745625600000000000,mohtel,24,12000,56,46940,56,51495,18000,12400,117524,108,117524,113,1402,1402,212,212,7,0,49,0
1745712000000000000,mohtel,24,12000,748,47688,748,52243,18000,12400,117639,115,117639,113,1402,1402,212,212,11,0,40,697
1745798400000000000,mohtel,24,12000,71,47759,71,52314,18000,12400,117792,153,117792,113,1402,1402,212,212,14,0,57,0
1745884800000000000,mohtel,24,12000,51,47810,51,52365,18000,12400,117905,113,117905,113,1402,1402,212,212,1,0,50,0
1745971200000000000,mohtel,24,12000,35,47845,35,52400,18000,12400,118014,109,118014,113,1402,1402,212,212,0,0,35,0
1746057600000000000,mohtel,24,12000,18,47863,18,52418,18000,12400,118091,77,118091,113,1402,1402,212,212,1,0,17,0
1746144000000000000,mohtel,0,12000,0,47863,0,52418,18000,12400,118091,0,118091,113,1402,1402,212,212,0,0,0,0
1746230400000000000,mohtel,48,12000,77,47940,77,52495,18000,12400,118366,275,118366,113,1402,1402,212,212,7,0,70,0
1746316800000000000,mohtel,24,12000,40,47980,40,52535,18000,12400,118491,125,118491,113,1402,1402,212,212,0,0,40,0
1746403200000000000,mohtel,24,12000,32,48012,32,52567,18000,12400,118610,119,118610,113,1402,1402,212,212,9,0,23,0
1746489600000000000,mohtel,24,12000,48,48060,48,52615,18000,12400,118752,142,118752,113,1402,1402,212,212,0,0,48,0
1746576000000000000,mohtel,24,12000,38,48098,38,52653,18000,12400,118897,145,118897,113,1402,1402,214,214,4,0,34,0
1746662400000000000,mohtel,24,12000,107,48205,107,52760,18000,12400,119264,367,119264,113,1411,1411,214,214,1,0,106,0
1746748800000000000,mohtel,24,12000,27,48232,27,52787,18000,12400,119349,85,119349,113,1411,1411,214,214,1,0,26,0
1746835200000000000,mohtel,24,12000,23,48255,23,52810,18000,12400,119473,124,119473,113,1411,1411,214,214,0,0,23,0
1746921600000000000,mohtel,24,12000,19,48274,19,52829,18000,12400,119554,81,119554,113,1411,1411,214,214,1,0,18,0
1747008000000000000,mohtel,24,12000,33,48307,33,52862,18000,12400,119648,94,119648,113,1411,1411,214,214,4,0,29,0
1747094400000000000,mohtel,24,12000,46,48353,46,52908,18000,12400,119721,73,119721,113,1411,1411,215,215,15,0,31,0
1747180800000000000,mohtel,24,12000,20,48373,20,52928,18000,12400,119846,125,119846,113,1411,1411,215,215,1,0,19,0
1747267200000000000,mohtel,24,12000,82,48455,82,53010,18000,12400,119998,152,119998,113,1411,1411,217,217,0,0,82,0
1747353600000000000,mohtel,24,12000,109,48564,109,53119,18000,12400,120214,216,120214,113,1411,1411,217,217,1,0,108,0
1747440000000000000,mohtel,24,12000,153,48717,153,53272,18000,12400,120673,459,120673,113,1411,1411,217,217,7,0,146,0
1747526400000000000,mohtel,24,12000,67,48784,67,53339,18000,12400,121034,361,121034,113,1411,1411,217,217,5,0,62,0
1747612800000000000,mohtel,24,12000,136,48920,136,53475,18000,12400,121398,364,121398,113,1411,1411,219,219,11,0,125,0
1747699200000000000,mohtel,24,12000,98,49018,98,53573,18000,12400,121688,290,121688,113,1411,1411,219,219,11,0,87,0
1747785600000000000,mohtel,24,12000,82,49100,82,53655,18000,12400,121950,262,121950,113,1411,1411,219,219,0,0,82,0
1747872000000000000,mohtel,24,12000,107,49207,107,53762,18000,12400,122197,247,122197,113,1411,1411,219,219,3,0,104,0
1747958400000000000,mohtel,24,12000,60,49267,60,53822,18000,12400,122382,185,122382,113,1411,1411,219,219,0,0,60,0
1748044800000000000,mohtel,24,12000,79,49346,79,53901,18000,12400,122593,211,122593,113,1411,1411,219,219,5,0,74,0
1748131200000000000,mohtel,24,12000,38,49384,38,53939,18000,12400,122797,204,122797,113,1411,1411,220,220,0,0,38,0
1748217600000000000,mohtel,24,12000,38,49422,38,53977,18000,12400,122966,169,122966,113,1411,1411,220,220,1,0,37,0
1748304000000000000,mohtel,24,12000,79,49501,79,54056,18000,12400,123129,163,123129,113,1411,1411,220,220,0,0,79,0
1748390400000000000,mohtel,24,12000,28,49529,28,54084,18000,12400,123308,179,123308,115,1580,1580,221,221,5,0,23,0
1748476800000000000,mohtel,24,12000,165,49694,165,54249,18000,12400,123492,184,123492,115,1580,1580,221,221,5,0,62,98
1748563200000000000,mohtel,24,12000,72,49766,72,54321,18000,12400,123770,278,123770,115,1580,1580,221,221,0,0,72,0
1748649600000000000,mohtel,24,12000,60,49826,60,54381,18000,12400,124054,284,124054,115,1580,1580,221,221,1,0,59,0
1748736000000000000,mohtel,24,12000,37,49863,37,54418,18000,12400,124190,136,124190,115,1580,1580,221,221,5,0,32,0
1748822400000000000,mohtel,24,12000,52,49915,52,54470,18000,12400,124693,503,124693,115,1580,1580,221,221,1,0,51,0
1748908800000000000,mohtel,24,12000,40,49955,40,54510,18000,12400,124901,208,124901,115,1580,1580,221,221,1,0,39,0
1748995200000000000,mohtel,24,12000,97,50052,97,54607,18000,12400,125341,440,125341,115,1580,1580,221,221,2,0,95,0
1749081600000000000,mohtel,24,12000,70,50122,70,54677,18000,12400,125530,189,125530,115,1580,1580,225,225,3,0,67,0
1749168000000000000,mohtel,0,12000,0,50122,0,54677,18000,12400,125530,0,125530,115,1580,1580,226,226,0,0,0,0
1749254400000000000,mohtel,48,12000,95,50217,95,54772,18000,12400,125834,304,125834,115,1580,1580,226,226,0,0,95,0
1749340800000000000,mohtel,24,12000,108,50325,108,54880,18000,12400,126227,393,126227,115,1580,1580,226,226,2,0,106,0
1749427200000000000,mohtel,24,12000,47,50372,47,54927,18000,12400,126615,388,126615,115,1580,1580,226,226,1,0,46,0
1749513600000000000,mohtel,24,12000,54,50426,54,54981,18000,12400,126920,305,126920,115,1583,1583,227,227,2,0,52,0
1749600000000000000,mohtel,24,12000,123,50549,123,55104,18000,12400,127394,474,127394,115,1583,1583,227,227,3,0,120,0
1749686400000000000,mohtel,24,12000,103,50652,103,55207,18000,12400,127821,427,127821,115,1583,1583,227,227,0,0,103,0
1749772800000000000,mohtel,0,12000,0,50652,0,55207,18000,12400,127821,0,127821,115,1583,1583,227,227,0,0,0,0
1749859200000000000,mohtel,48,12000,90,50742,90,55297,18000,12400,128426,605,128426,115,1583,1583,227,227,0,0,90,0
1749945600000000000,mohtel,24,12000,65,50807,65,55362,18000,12400,128741,315,128741,115,1583,1583,227,227,8,0,57,0
1750032000000000000,mohtel,24,12000,70,50877,70,55432,18000,12400,128923,182,128923,115,1583,1583,227,227,2,0,68,0
1750118400000000000,mohtel,24,12000,61,50938,61,55493,18000,12400,129320,397,129320,115,1583,1583,227,227,6,0,55,0
1750204800000000000,mohtel,24,12000,144,51082,144,55637,18000,12400,129880,560,129880,115,1583,1583,227,227,4,0,140,0
1750291200000000000,mohtel,24,12000,69,51151,69,55706,18000,12400,130101,221,130101,115,1583,1583,227,227,2,0,67,0
1750377600000000000,mohtel,0,12000,0,51151,0,55706,18000,12400,130101,0,130101,115,1583,1583,227,227,0,0,0,0
1750464000000000000,mohtel,48,12000,202,51353,202,55908,18000,12400,131138,1037,131138,115,1583,1583,227,227,4,0,198,0
1750550400000000000,mohtel,24,12000,51,51404,51,55959,18000,12400,131242,104,131242,115,1583,1583,227,227,3,0,48,0
1750636800000000000,mohtel,24,12000,39,51443,39,55998,18000,12400,131559,317,131559,115,1583,1583,227,227,1,0,38,0
1750723200000000000,mohtel,24,12000,79,51522,79,56077,18000,12400,131848,289,131848,115,1583,1583,227,227,5,0,74,0
1750809600000000000,mohtel,24,12000,79,51601,79,56156,18000,12400,132239,391,132239,115,1583,1583,227,227,5,0,74,0
1750896000000000000,mohtel,24,12000,103,51704,103,56259,18000,12400,132458,219,132458,115,1583,1583,227,227,0,0,103,0
1750982400000000000,mohtel,24,12000,72,51776,72,56331,18000,12400,132632,174,132632,115,1583,1583,227,227,0,0,72,0
1751068800000000000,mohtel,24,12000,81,51857,81,56412,18000,12400,133054,422,133054,115,1583,1583,227,227,0,0,81,0
